NO ./textures/NO.xpm
SO ./textures/SO.xpm
WE ./textures/WE.xpm
EA ./textures/EA.xpm

C 0,100,255
F 220,100,200


11111111111111111111111111
10000000000000000000000001
10000000000000000000000001
10000000000000000000000001
10000000N0000001111111111111111111111111111111
10000000000000000000100001
10000000000000000000000001
100000000000000000010000011111
100000000000000000010000000000111111111111
10000000000000000000001111111111111111111
100000000000000000000010000000001
10000000001111111111111111111111111111111111111
11111111111

